NO ./textures/brick.xpm
SO ./textures/greystone.xpm
WE ./textures/purplestone.xpm
EA ./textures/wall.xpm
F 220,100,0
C 225,30,0

1111111111111111111111111111111111111111111111111
1111101
1000N01
1110001
1111111
