NO                  ./textures/brick.xpm
SO              ./textures/greystone.xpm
                                                                                                                WE ./textures/purplestone.xpm
            EA ./textures/wall.xpm
F 220,100,0
C 225,30,20

1111111111111111111111111111111111111111111111111
11111101
1000N01
1110001
1111111
