NO          ./textures/brick.xpm  
SO             ./textures/greystone.xpm 

                                                                                                                WE ./textures/purplestone.xpm
           EA ./textures/wall.xpm

F 220,100,0
C 225,30,12

    1111111
     11111D1
    111S001
    11111111
