NO                 ./textures/action/north.xpm
SO              ./textures/action/south.xpm
                        WE ./textures/action/west.xpm
            EA ./textures/action/east.xpm

F 20,20,40
C 0,204,204

11111111111111111111111111111111
10000000000000000000000000000001
10111010001000101000100010101001
10001010001000101000100010001001
10001010001000101000100010001001
10001010001000101000100010001001
10000000000000000000000000000001
10111011101110111011101110111001
10001000100010001000100010001001
10001000100010001000100010001001
10111011101110111010111011101101
10000000000000000000000000000001
10000001111111111111111110000001
10000000000000000000000000000001
10100010001000100010001000100001
10100010001000100010001000100001
10000000000000000000000000000001
1111111D11111D11111D11111D111111
10000000000000000000000000000001
10000000000000000000000000000001
10000000000000000000000000000001
1000000S000000000000000000000001
10000000000000000000000000000001
10000000000000000000000000000001
10000000000000000000000000000001
10000000000000000000000000000001
10000000000000000000000000000001
10000000000000000000000000000001
10000000000000000000000000000001
10000000000000000000000000000001
10000000000000000000000000000001
11111111111111111111111111111111
