NO                  ./textures/zomoroda/north.xpm
SO              ./textures/zomoroda/south.xpm
                        WE ./textures/zomoroda/west.xpm
            EA ./textures/zomoroda/east.xpm
F 51,51,51
C 0,153,255

       11111111111111111111111111111111111
  11111100000000000000000000000000000000001
  10000011111111111111111111111111111111001
  10111100000000000000000000000000000001001
  10000011111111111111111111111111111101001
  11111000000000000000000000000000000101001
  10001011111111111111111111111111110101001
  10101010000000000000000000000000000101001
  10001010111111111111111111111111110101001
  10111010000000000000000000000000000101001
  10000010111111111111111111111111110101001
  11111110100000000000000000000000000101001
  10000000101111111111111111111111110101001
  10111111101000000000000000000000000101001
  10000000001011111111111111111111110101001
  10111111111000000000000000000000000101001
  10000000000000000000000000000000000001001
  1000000000000000000000000000000000000S001
  11111111111111111111111111111111111111111

