NO                  ./textures/north.xpm
SO              ./textures/south.xpm
                        WE ./textures/west.xpm
            EA ./textures/east.xpm
F 51,51,51
C 0,153,255

11111111111111111111111111111111
10000000000000000000000000000001
10111010001000101000100010101001
10001010001000101000100010001001
10001010001000101000100010001001
10001010001000101000100010001001
10000000000000000000000000000001
10111011101110111011101110111001
10001000100010001000100010001001
10001000100010001000100010001001
10111011101110111010111011101101
10000000000000000000000000000001
10000001111111111111111110000001
10000000000000000000000000000001
10100010001000100010001000100001
10100010001000100010001000100001
10000000000000000000000000000001
11110011111110111111111110011111
10000000000000000000000000000001
10000000000000000000000000000001
10000000000000000000000000000001
10000000000000000000000000000001
10000000000000000000000000000001
10000000000000000000000000000001
10000000000000000000000000000001
10000000000000000000000000000001
10000000000000000000000000000001
10000N00000000000000000000000001
10000000000000000000000000000001
10000000000000000000000000000001
10000000000000000000000000000001
11111111111111111111111111111111
