NO                  ./textures/north.xpm
SO              ./textures/south.xpm
                        WE ./textures/west.xpm
            EA ./textures/east.xpm
F 51,51,51
C 0,153,255

                 111111111111111111111111
         111111110000000000000000000000001
     1111100000001111111111111111111111001
   1110000011111100000000000000000000010001
  11000011100000101111111111111111110111001
  10001110001110001000000000000000100000101
  10001000100010001111111111111110101110101
  10111011101011110000000000000010100000101
  10001000001000000111111111111010101111101
  10111011111011110000000000001010001000001
  10001010001000001111111111101011101011111
  10001010111011111000000000001000001000001
  10111010000000000111111111111111101110101
  10000010001111111000000000000000001000101
  11111110111000000111111111111111111011101
       1000000000S0000000000000000000000001
       111111111111111111111111111111111111
